4 3 3 3 3 3 3 3 3 3 3 3 3 3 3 3 3 9 9 3 3 3 3 3 3 3 3 3 3 3 3 3 3 3 3 4
3 7 7 7 7 7 7 7 7 7 7 7 7 7 7 7 7 5 5 7 7 7 7 7 7 7 7 7 7 7 7 7 7 7 7 3
3 7 7 7 7 7 7 7 7 7 7 7 7 7 7 7 7 5 5 7 7 7 7 7 7 7 7 7 7 7 7 7 7 7 7 3
3 7 7 1 5 5 1 7 7 1 5 5 5 5 1 7 7 5 5 7 7 1 5 5 5 5 1 7 7 1 5 5 1 7 7 3
3 7 7 5 7 7 5 7 7 5 7 7 7 7 5 7 7 5 5 7 7 5 7 7 7 7 5 7 7 5 7 7 5 7 7 3
3 7 7 5 7 7 5 7 7 5 7 7 7 7 5 7 7 5 5 7 7 5 7 7 7 7 5 7 7 5 7 7 5 7 7 3
3 7 7 1 5 5 1 7 7 1 5 5 5 5 1 7 7 6 6 7 7 1 5 5 5 5 1 7 7 1 5 5 1 7 7 3
3 7 7 7 7 7 7 7 7 7 7 7 7 7 7 7 7 7 7 7 7 7 7 7 7 7 7 7 7 7 7 7 7 7 7 3
3 7 7 7 7 7 7 7 7 7 7 7 7 7 7 7 7 7 7 7 7 7 7 7 7 7 7 7 7 7 7 7 7 7 7 3
3 7 7 1 5 5 1 7 7 1 1 7 7 1 5 5 5 5 5 5 5 5 1 7 7 1 1 7 7 1 5 5 1 7 7 3
3 7 7 1 5 5 1 7 7 5 5 7 7 1 5 5 5 6 6 5 5 5 1 7 7 5 5 7 7 1 5 5 1 7 7 3
3 7 7 7 7 7 7 7 7 5 5 7 7 7 7 7 7 5 5 7 7 7 7 7 7 5 5 7 7 7 7 7 7 7 7 3
3 7 7 7 7 7 7 7 7 5 5 7 7 7 7 7 7 5 5 7 7 7 7 7 7 5 5 7 7 7 7 7 7 7 7 3
4 3 3 3 3 3 6 7 7 5 6 5 5 5 1 7 7 5 5 7 7 1 5 5 5 6 5 7 7 6 3 3 3 3 3 4
7 7 7 7 7 7 3 7 7 5 6 5 5 5 1 7 7 1 1 7 7 1 5 5 5 6 5 7 7 3 7 7 7 7 7 7
7 7 7 7 7 7 3 7 7 5 5 7 7 7 7 7 7 7 7 7 7 7 7 7 7 5 5 7 7 3 7 7 7 7 7 7
7 7 7 7 7 7 3 7 7 5 5 7 7 7 7 7 7 7 7 7 7 7 7 7 7 5 5 7 7 3 7 7 7 7 7 7
7 7 7 7 7 7 3 7 7 5 5 7 7 8 3 3 2 7 7 2 3 3 8 7 7 5 5 7 7 3 7 7 7 7 7 7
2 3 3 3 3 3 6 7 7 1 1 7 7 3 8 3 2 7 7 2 3 8 3 7 7 1 1 7 7 6 3 3 3 3 3 2
7 7 7 7 7 7 7 7 7 7 7 7 7 3 3 7 7 7 7 7 7 3 3 7 7 7 7 7 7 7 7 7 7 7 7 7
7 7 7 7 7 7 7 7 7 7 7 7 7 3 3 7 7 7 7 7 7 3 3 7 7 7 7 7 7 7 7 7 7 7 7 7
2 3 3 3 3 3 6 7 7 1 1 7 7 3 8 3 3 3 3 3 3 8 3 7 7 1 1 7 7 6 3 3 3 3 3 2
7 7 7 7 7 7 3 7 7 5 5 7 7 8 3 3 3 3 3 3 3 3 8 7 7 5 5 7 7 3 7 7 7 7 7 7
7 7 7 7 7 7 3 7 7 5 5 7 7 7 7 7 7 7 7 7 7 7 7 7 7 5 5 7 7 3 7 7 7 7 7 7
7 7 7 7 7 7 3 7 7 5 5 7 7 7 7 7 7 7 7 7 7 7 7 7 7 5 5 7 7 3 7 7 7 7 7 7
7 7 7 7 7 7 3 7 7 5 5 7 7 1 5 5 5 5 5 5 5 5 1 7 7 5 5 7 7 3 7 7 7 7 7 7
4 3 3 3 3 3 6 7 7 1 1 7 7 1 5 5 5 6 6 5 5 5 1 7 7 1 1 7 7 6 3 3 3 3 3 4
3 7 7 7 7 7 7 7 7 7 7 7 7 7 7 7 7 5 5 7 7 7 7 7 7 7 7 7 7 7 7 7 7 7 7 3
3 7 7 7 7 7 7 7 7 7 7 7 7 7 7 7 7 5 5 7 7 7 7 7 7 7 7 7 7 7 7 7 7 7 7 3
3 7 7 1 5 5 1 7 7 1 5 5 5 5 1 7 7 5 5 7 7 1 5 5 5 5 1 7 7 1 5 5 1 7 7 3
3 7 7 1 5 6 5 7 7 1 5 5 5 5 1 7 7 1 1 7 7 1 5 5 5 5 1 7 7 5 6 5 1 7 7 3
3 7 7 7 7 5 5 7 7 7 7 7 7 7 7 7 7 7 7 7 7 7 7 7 7 7 7 7 7 5 5 7 7 7 7 3
3 7 7 7 7 5 5 7 7 7 7 7 7 7 7 7 7 7 7 7 7 7 7 7 7 7 7 7 7 5 5 7 7 7 7 3
9 5 6 7 7 5 5 7 7 1 1 7 7 1 5 5 5 5 5 5 5 5 1 7 7 1 1 7 7 5 5 7 7 6 5 9
9 5 6 7 7 1 1 7 7 5 5 7 7 1 5 5 5 6 6 5 5 5 1 7 7 5 5 7 7 1 1 7 7 6 5 9
3 7 7 7 7 7 7 7 7 5 5 7 7 7 7 7 7 5 5 7 7 7 7 7 7 5 5 7 7 7 7 7 7 7 7 3
3 7 7 7 7 7 7 7 7 5 5 7 7 7 7 7 7 5 5 7 7 7 7 7 7 5 5 7 7 7 7 7 7 7 7 3
3 7 7 1 5 5 5 5 5 6 6 5 5 5 1 7 7 5 5 7 7 1 5 5 5 6 6 5 5 5 5 5 1 7 7 3
3 7 7 1 5 5 5 5 5 5 5 5 5 5 1 7 7 1 1 7 7 1 5 5 5 5 5 5 5 5 5 5 1 7 7 3
3 7 7 7 7 7 7 7 7 7 7 7 7 7 7 7 7 7 7 7 7 7 7 7 7 7 7 7 7 7 7 7 7 7 7 3
3 7 7 7 7 7 7 7 7 7 7 7 7 7 7 7 7 7 7 7 7 7 7 7 7 7 7 7 7 7 7 7 7 7 7 3
4 3 3 3 3 3 3 3 3 3 3 3 3 3 3 3 3 3 3 3 3 3 3 3 3 3 3 3 3 3 3 3 3 3 3 4
