###############
#A....#......B#
###.#.#####.#.#
#...#.....#.#.#
#.#####.#.#.#.#
#.....#.#.#.#.#
#####.#.#.#.#.#
#.....#.......#
#.###########.#
#.............#
###############